 9 11
...........
...........
..##.......
...S#.#.##.
....#.#.F..
....#.#.##.
....#.#....
...........
...........
